111111
100P01
1P00C1
1C00E1
111111