11101111111
01111000001
100000P0001
1000CCC0001
11111111111