111111
110001
1P10C1
1100E1
111111