111111
10001
1P00C1
1C00E1
111111