11111111111111111111111111111111
1P000000000000000000000111111111
10111C000000000000000C0000000001
10000000C00000011110000000000C01
1000000000011111111000000C000001
10000111111000000000000000000001
11100C00000000000000000111000001
10000000000000000000000000000001
11111111111111000000000000000001
11111100000000000001111111000001
10000000000000000000000000000011
11111110000000000000000000000E11
11111111111111111111111111111111