111111111111111111111111111111111111111111111111111111111111
1P000000000000000000C0000000000000000000000000000000000000C1
11111111111111100000000C0000000000000000000000000C0000000101
1C0000000000000000000000000000011111100000000000000000000001
101110000000000001110000000000000011110000000000000000111111
10000000000000000000000000111111111000000000110C0000000000C1
111100001111111111111111111111000000000000000000000011111101
1C000000000000000000000C000000000000000000000000000000000001
101100000000000000000000000000C00000000000000011111111111111
1000000000000000000000000000000000000000000000000000000000C1
111111111111100000000000000000000000000011111111111111111101
1C000000000000C000000C00000000000000000000000000000000000001
10000000000000C000000000011111111111111111111110000011111111
100000000000000000CC00000000000000000000000000000000000000C1
111111111111111110000000000000000000000000000000111111111101
1C0000000000000000000000000000000000000000000000000000000001
101100000000000000000000011111111100011111111111111111111111
10000000000000000000000000000000000000CC000000000000000000C1
111111100000000000000000000000000000000000001111111111111101
1C000000000000C0000000001111110000000000000000000000000000E1
111111111111111111111111111111111111111111111111111111111111